cluster,0,1,2,3,4,5,6,7,8,9,10
0,562,0,0,0,0,0,0,0,0,0,0
1,0,965,1,0,0,0,0,0,0,0,0
2,0,0,0,0,0,0,0,0,0,1373,0
3,0,0,0,0,0,1,0,0,637,0,223
4,0,0,0,0,0,931,0,0,0,0,0
5,0,0,0,0,1031,0,0,0,0,0,0
6,0,0,0,402,0,0,0,0,0,0,0
7,0,0,0,0,0,0,0,1584,0,0,0
8,0,0,1062,0,0,0,0,0,0,0,0
9,0,0,0,0,0,0,799,0,0,0,0
